# # # # # # # # # # # # # # #
# . . . . . . . . . . . . . #
# . # # # # # # # # # # # . #
# . # . . . . . . . . . # . #
# . # . # # # # # # # . # . #
# . # . # . . . . . # . # . #
# . # . # . # # # . # . # . #
# . # . # . . . # . # . # . #
# . . . # . # F # . . . # . #
# . # . # . # # # . # . # . #
# . # . # . . . . . # . # . #
# . # . # # # # # # # . # . #
# . # . . . . . . . . . # . #
# . # # # # # # # # # # # . #
# . . . . . . . . . . . . . #
# # # . # # # # # # # # # # #
# # # S # # # # # # # # # # #