# # # # # # # # # # # # # # #
# . . . . . . . . . . . . . #
# . # . # . # . # . # . # . #
# . F . . . . . . . . . . . #
# . # . # . # . # . # . # . #
# . . . . . . . . . . . . . #
# . # . # . # . # . # . # . #
# . . . . . . . . . . . . . #
# . # . # . # . # . # . # . #
# . . . . . . . . . . . . . #
# . # . # . # . # . # . # . #
# . . . . . . . . . . . . . #
# . # . # . # . # . # . # . #
# . . . . . . . . . . . . . #
# . # . # . # . # . # . # . #
# # # S # # # # # # # # # # #