# # # # # # # # # # # # # # #
# . . . . . . . # # # . . . #
# . # . # . # # # . . . # # #
# . # . # . # . . . # # # # #
# . # . # . # . # . # . . . #
# . # . # . . . # # # . # F #
# . # . # . # # . . . . # # #
# . . . . . . . . # # # # # #
# . # # # # # # . . . . # # #
# . # . . . # # . # # # # # #
# . # . # . . . . . . . # # #
# # # S # # # # # # # # # # #   