# # # # # # # # # # # # # # #
# . . . . . . # . . # . . . #
# . # . # . # # # . # . # # #
# . # . # . # . . . # . # # #
# . # . # . # . # . # . . . #
# . # . # . . . # . # . # F #
# . # . # # # # # . # . # # #
# . . . . . . . # . # . # # #
# . # # # # # . # . . . # # #
# . # . . . # . # # # # # # #
# . # . # . . . . . . . # # #
# # # S # # # # # # # # # # #